9 19 

# # # #     
#### ### # # # ### 
 #     #         # 
 # # # # # # ### ##
 # # #   # #   #   
 ### ### # ##### ##
   #   # #   # # # 
 # # ### # # # ### 
 #     # # # 